11111
100E1
1C001
1P0111
11111
